  ######
  #.^^@#
  #.00.#
  ##.###
   #.#
   #.#
####.#
#....##
#.#...#
#...#.#
###...#
  #####
