######
#.^^.#
#.00.#
#..@.#
######
